TileSize: 32.000000
Digits: 2
Rows: 23
Columns: 40

16161616161616161616161616161616161616161616161616161616161616161616161616161616
16341919191919191919191919191919191919191919191919191919191919191919191919193516
16170302030203020302030203020302030203020302030203020302030203020302030203021516
16170104050505050505050506121313131313131314010001000100010001000100010001001516
16170307212223212223212208151616161616161617010001000100010001000100010001001516
16170107242526242526242508151616161616161617030203020302030203020302030203021516
16170307272829272829272808151616161616161617010001000100010001000100010001001516
16170107212223212223212208151616161616161617030203020302030203020302030203021516
16170307242526242526242508181919191919191920010001000100010001000100010001001516
16170107272829272829272808000100010001000100030203020302030203020302030203021516
16170307212223212223212232050505050506000100010001000100010001000100010001001516
16170107242526242526242526242526242508020302030203020302030203020302030203021516
16170307272829272829272829272829272808000100010001000100010001000100010001001516
16170107212223212223212223212223212208020302030203020302030203020302030203021516
16170307242526242526242526242526242508000100010001000100121313131313131401001516
16170107272829272829272829272829272808020302030203020302151616161616161703021516
16170307212223212223212223212223212208000100010001000100151616161616163613133716
16170009101010101010101010101010101011000100030203020302151616161616161616161616
16170100010001000100010001000100010001000100010001000100151616161616163419193516
16170302030203020302030203020302030203020302030203020302181919191919192003021516
16170001000100010001000100000000000100010001000100010001000100010001000100011516
16361313131313131313131313131313131313131313131313131313131313131313131313133716
16161616161616161616161616161616161616161616161616161616161616161616161616161616
