TileSize: 32.000000
Digits: 2
Rows: 23
Columns: 38

6934353635363536353635363536353635363536353635363536353635363536353635363769
3839010001000100010001000100010001000100010001000100010001000100010001004243
4445030203020302030203020302030203020302030203020302030203020302030203025047
4445010405050505050505050612131313131313131401000100010001000100010001005051
4445030721222321222321220815161616161616161701000100010001000100010001005051
4445010724252624252624250815161616161616161703020302030203020302030203025051
4445030727282927282927280815161616161616161701000100010001000100010001005051
4445010721222321222321220815161616161616161703020302030203020302030203025051
4445030724252624252624250818191919191919192001000100010001000100010001005051
4445010727282927282927280800010001000100010003020302030203020302030203025051
4445030721222321222321223205050505050600010001000100010001000100010001005051
4445010724252624252624252624252624250802030203020302030203020302030203025051
4445030727282927282927282927282927280800010001000100010001000100010001005051
4445010721222321222321222321222321220802030203020302030203020302030203025051
4445030724252624252624252624252624250800010001000100121313131313131401005051
4445010727282927282927282927282927280802030203020302151616161616161703025051
4445030721222321222321222321222321220800010001000100151616161616161701005051
4445000910101010101010101010101010101100010003020302151616161616161703025051
4445010001000100010001000100010001000100010001000100151616161616161701005051
4449030203020302030203020302030203020302030203020302181919191919192003025051
5253545553545553545553545553545553545553545553555355530055545553545553555657
5859606060606060606060606060606060606060606060606060606060606060606060616263
6465666666666666666666666666666666666666666666666666666666666666666666666869
