TileSize: 32.000000
Digits: 2
Rows: 23
Columns: 40

34343434343434343434343434343434343434343434343434343434343434343434343434343434
34373232323232323232323232323232323232323232323232323232323232323232323232323834
34300000000000000000000000000000000000000000000000000000000000000000000000002934
34300000000000000000000000000000000000000000000000000000000000000000000000002934
34300000000000000000000000000000000000000026272727272727272727272728000000002934
34300000000000000000000000000000000000000029343436363636363636343430000000002934
34300000000000000000000000000000000000000029343732323232323232383530000000002934
34300000000000000000000000000000000000000029343000000000000000293430000000002934
34300000000000000000000000000000000000000007080900000000000000293430000000002934
34300000000000000000000000000000000000000029353000000000000000070809000000002934
34300000000000000000000000000000000000000029343000000000000000293530000000002934
34300000000000000000000000000000000000000029343000000000000000293430000000002934
34300000000000000000000000000000000000000029343000000000000000293539272706274034
34300000000000000000000000000000000000000029343000000000000000293437323210323834
34300000000000000000000000000000000000000029353000000000000000293530000000002934
34300000000000000000000000000000000000000007080900000000000000293430000000002934
34300000000000000000000000000000000000000029353927272727272727403430000000002934
34300000000000000000000000000000000000000029343536363636363636353530000000002934
34300000000000000000000000000000000000000031323232323232323232323233000000002934
34300000000000000000000000000000000000000000000000000000000000000000000000002934
34300000000000000000000000000000000000000000000000000000000000000000000000002934
34392727272727272727272727272727272727272727272727272727272727272727272727274034
34343434343434343434343434343434343434343434343434343434343434343434343434343434
