TileSize: 32.000000
Digits: 1
Rows: 23
Columns: 40

0000000100000000000000000000000000000000
0000000100000000000000000000000000000000
0000000100000000000000000000000000000000
0000000100000000000000000000000000000000
0000000100000000000000001111111000000000
0000000100000010000010000000000000000000
0000000100000010000010000000000000000000
0000000100000010000010000000000000000000
0000000100000010000010000000000000000000
0000000100000010000010000000000000000000
0000000100000010000010000000000000000000
0000000100000010000010000000000000000000
0000000100000010000000000000000000000000
0000000100000010000000000000000000000000
0000000100000010000000000000000000000000
0000000100000010000000000000000000000000
0000000100000010000000000000000000000000
0000000100000010000000000000000000000000
0000000100000010000000000000000000000000
0000000100000010000000000000000000000000
0000000000000010000000000000000000000000
0000000000000010000000000000000000000000
0000000000000010000000000000000000000000
