TileSize: 32.000000
Digits: 1
Rows: 23
Columns: 40

0000010000000000000000000010000000000000
0000010000000000000000000010000000000000
0000010000000001000000000010000000000000
0000010000000001000000000010011111000000
0000010000000001000001000010010000000000
0000100011111111111101000110010000000000
0000100000000000000001000100010000000000
0000100000000000000001000000010111111111
0000000000000000010001000000010000000000
0000000000000000010001000000010000000000
0000000000000000010001000000010000000000
0000001111111110010001000000010000000000
0000001000000000010001000001110000000000
0000001000000000010001000111011111100000
0000011000000001110001000100000000100000
0000010001111111010001001000000000100000
0000010000000000001001001000000000110000
0000010000000000001001000100000000010000
0000010000000010001001000100000000000000
0000010000000010001000000000000000000000
0000010000000010001000000011110001110000
0000010000000010000000000000011110000000
0000011100000010000000000000000000000000
