TileSize: 32.000000
Digits: 2
Rows: 30
Columns: 55

37323232323232323232323232323232383434343434343434343434343732323232323232323232323232323232323232323232323238
30000000000000000000000000000000293434363435353435353434373300000000000000000000000000000000000000000000000029
30000000000000000000000002020000293635343434343435353437330000000000020202020000000000000000000000000000000029
30000000000000000000000002020000293635343634353434343733000000000000000000000000000303030000000002020200000029
30000000000000000000000000000000293634343534363634373300000000000000000000030000000000000000030202020200000029
30000000001112121212121300000000313834343435343437330000000000000000000000000000000000000000030002020200000029
30262727281415151515151600000000003138343434343733000000000000020202000000000000000000000000000300000000030029
30293434301718181818222313000000000031383436373300000000000000020202030000000000000000000000000000000000000029
30293434300000000500172216000000000000313238392800000000000000020202000026272727272727272800000000000000000029
30313232330000000000001423130000000000000031383928000000000000020200000031323232323232383928000000000000000029
30000000000000000000001722160000000000000000313839280000000003000000000000000000000000313839280000000003000029
30000000000000010000000014160000000000000000003138392800000000000000000000000000000000003138392800000003000029
30000000000000000000000014160000000000000000000031383928000000000000000003000000010200000031383928000000000029
30000000000000000000000017190000000000000000000200293639280004000000000000000000010202000000313830000000000029
30000204262727272727272727280000000002020000000000293636392727272727272727280000000202000000002930000000030029
30000026403732323232323232330000000002020000000000293636363636363636363636392800000202000000002939272800000029
30002640373300000000000000000000000002020000000026403436363636363636363636363928010000000000002937323300000029
39274037330000000000000000000000000000000000000029363636343435363534353636363639280000000000002930000000000029
36373233000000000000000000000000000000000000002640363634353436363535353636363636300000000300002930000000000029
36300000000000000000000000000000000000000000002936363534363536343636343436363636300000000300002930020000262740
36300000000000000000000000000000000000000000002936343634343534363636353436363636300000000300002930020200313238
34300000000000000000000000000000000000000000264036363636343636363434343436363437330000000000002930000000000029
36300000000202020026272727272727272727272727403636363636363535363436343636363733000000000000002930000000000029
34392800000202020031323232323232323232323232323232323232383436363636363636373300000000000000002939272803030029
36363000000002000000000000000000000000000000000000000001313232323232323232330000000000000000002937323300030029
34363000000000000000000000000000000000000001000000000000000000000000000000000000000202020000002930000000030029
36343928000000000000000000000003030300000000030303000000000000000000000000000000000202020000002930000000000029
36343630000000000000000000000000000000030001010103000000000000000000000000000000000002000000002930000003030029
34363430000000000000000000000000000000000000000000000000000000000000000000000000000000000000002930000000000029
34363436272727272727272727272727272727272727272727272727272727272727272727272727272727272727274039272727272740
