TileSize: 32.000000
Digits: 2
Rows: 23
Columns: 55

37323232323232323232323232323232323232323834353435343537323232323232383435353435343437323232323232323232323238
30000200000000000000000202000000000000023138353434353733000000000000313834343434353430000000000000000000000029
30000200000000000000000200000000020000000031383535373300050505000000003138343535343530000000000000000000000029
30000000050000000500000303000000000000000000313232330000000000000000000031383435343430000000000000030000000029
30000000000000000000000000000000000000000000000000000000000000000000000000313834353430000000000000000000000029
30000204000000000000000000000000000000000000000000000000000000000000000000003138343430000000000011130000000029
30000004040000000500000000000000000000000000000000000000000000000004000000000031383430000000000014160000030029
30000000000000000500000000000000000000000000000000000000000000000000000000000000313233000000000014160000030029
30000102000000050500000011121212121212121212121212121212121212121300000000000000000000000000000014160003000029
30000102000000000000001124211818181818181818181818181818181818222313000000000500000000000000000014160000000029
30000102000002000000112421190200000000020000000000000000000000172223130000000500000000000000000014160000000029
30000001000001000011242119000000000003000000000000000000000000001722231300000000000000000000001124160000000029
30000000000000001124211900000000000000000000000000020000000000000017222313000000000000000000001421190000000029
30000000000000112421190000000000000000000000000200000000000000000000172223130000000000000000001416000000000029
30000204000011242119000000000000000000000000000000000000000000000000001722231300000000000011122416000000000029
30000202000014211900000000000000000000000000000000000000000003000004030317222312121212121224211819000000000029
30000000000017190000000000000000000000262727272800000000000303000000000000171818181818181818190000000000000029
30000000000000000000000000000000000026403636363928000000000000000000000000000000000000000000000000000000000029
30000000000500020500050000000000002640363634363639280000000000000000030300000000000000000300000000000000000029
30000000000500000505000000000000264036343536353636392800000000000000000303030300000000000003000000000000000029
30000000000000000000000000000026403636363436343436363928000000000000000000000003030000000000000000000000000029
30000000000000000000000000002640363434343536363634343639280000000000000000000000000000000000000000000000000029
39272727272727272727272727274036363635363634343636363636392727272727272727272727272727272727272727272727272740
