TileSize: 32.000000
Digits: 2
Rows: 23
Columns: 39

343434343434343434343434343434343434343434343434343434343434343434343434343434
343732323232323232323232323232323232323232323232323232323232323232323232323834
343000000000000000000000000000001515151500000000000000000000000000000000002934
343000000000000000000000000000001515151500000000000000000000000000000000002934
343000000400000000000000000004151515151515151515151500000000000000000400002934
343000000404000015151515151515151515151515151515151515001515151500000400002934
343000000001040015151515151515151515151515151515151515151515151500000004002934
343000010201040015151515000000000000151515151515151515151515151500040400002934
343015151515151515151515000200000000000015151515151515151515151500040000002934
343015010000000000000000000000020000000000000000151515151515151500000000002934
343015000101020101000201010000150000000000000000020202151515151515150000002934
343015000000000000000004001515151500000101010100000202020200000000000000002934
343015000000000000000000001515151515151500000000000002020200000400000000002934
343015001515151500000000000015151515000000000000000002020000000004040000002934
343000151515151515150000000000000000000000000015151515151515151500040400002934
343000000000001515151500000000000000000000040015000000000015150000000404002934
343000000000001515151515000202000000000000151500000011121213000000000000002934
343000000000000000001515151502000000021515151515151514151516000000000000002934
343000000000000000000015151515151515151500000000000017181819000000000000002934
343000000000000000000000000000000000000000000000000000000000000000000000002934
343000000000000000000000000000000000000000000000000000000000000000000000002934
343927272727272727272727272727272727272727272727272727272727272727272727274034
343434343434343434343434343434343434343434343434343434343434343434343434343434
